11111111
100F00P1
1C00EC01
10C0C0F1
11111111