1111111111111111111111111111
100010000CC00001100001000C01
1100C000C000C0000C000C0000P1
11000CC00C000C000000000000E1
1111111111111111111111111111