1111111111111111111111111111111
100010000CC00001100001000C0F001
1010C00FC000C0000C000C0001P0001
10000CC00C000100000C000000C0001
1000F00011001E100000F0011000001
10C000CC00F000CC00C0000C0000001
100010000CC00001000001000C00001
1100C111C000C0000C000C00000F001
110000C00C000100000010000000001
11000CF001000C000000000000C0001
110001000C0F0100000010000010001
110000C000F00C0000000000F000001
1111111111111111111111111111111