1111111111111111111111111111111
100010000CC00001100001000C00001
1010C000C000C0000C000C0001P0001
10000CC00C000100000C000000C0001
1000000011001E10000000011000001
10C000CC000000CC00C0000C0000001
100010000CC00001000001000C00001
1100C111C000C0000C000C000000001
110000C00C000100000010000000001
11000C0001000C000000000000C0001
110001000C000100000010000010001
110000C000000C00000000000000001
1111111111111111111111111111111