111111111
1E0000CC1
1TTT00001
1P0000S01
111111111