111111111
1E0000CC1
1FFF00001
1P0000S01
111111111