11111111
11P00001
10000111
1CC001E1
11111111